picogram per mililiter: pg/ml

nanogram per mililiter: ng/ml

nanogram per deciliter: nanogram per deciliter

microgram per mililiter: µg/ml

microgram per deciliter: µg/dL

gram per deciliter: gram per deciliter

milimole per liter: mmol/L

miliequivalent per liter: mEq/L

miligram per deciliter: mg/dL

x 10^9 per liter: x 10^9/L

units per liter: U/l

microinternational units per mililiter: µU/ml

liters-per-minute: l/min

kilowatt-hours: kWh

milimeter: mm

centimeter: cm

meter: m

kilometer: km

percent: %

ratio: ratio

dose: dose

mililiter per minute per 1.73m^2: ml/min/1.73m²

seconds: s

minutes: min

femtoliter: fl

mililiter: ml

liter: l

cubic_meter: m³

picogram: pg

microgram: µg

miligram: mg

gram: g

kilogram: kg

